6,1,1,1,1,1,1,1,1,1,1,1,2,2,2,1,1,1,1,1,1,1,1,12,12,1,1,1,1,1,1,2,2,2,1,1,1,6
6,11,0,0,0,0,0,0,0,0,0,0,0,2,2,0,0,0,0,0,0,0,0,4,4,0,0,11,0,0,2,2,2,2,0,11,0,6
6,10,0,0,0,0,0,0,0,0,0,0,0,0,2,2,0,0,0,0,0,0,0,4,4,0,0,10,0,2,2,2,0,0,0,10,0,6
6,0,0,0,0,2,2,0,0,11,0,0,0,0,0,2,2,2,2,2,0,0,0,4,4,0,0,0,2,2,2,0,11,0,0,0,0,6
6,0,0,0,0,0,0,0,0,10,0,0,0,0,0,0,0,2,2,2,2,2,2,3,3,2,2,2,2,0,0,0,10,0,0,0,0,6
6,0,0,0,0,0,0,0,0,0,0,0,0,0,0,0,0,0,0,0,0,2,2,3,3,2,2,0,0,0,0,0,0,0,0,0,0,6
6,0,2,2,2,2,0,0,0,0,0,0,4,4,4,4,4,4,4,4,4,4,4,4,4,4,4,4,4,4,4,4,4,0,0,0,0,6
6,0,2,2,2,2,2,2,0,0,0,0,4,4,4,4,4,4,4,4,4,4,4,4,4,4,4,4,4,4,4,4,4,0,0,0,0,6
6,0,0,0,2,2,2,0,0,0,0,0,4,4,0,0,0,0,0,0,0,0,0,0,0,0,4,4,0,0,0,4,4,0,0,0,0,6
6,0,11,0,0,0,0,0,4,4,4,4,4,4,4,4,4,4,3,3,0,0,0,0,0,0,4,4,0,0,0,4,4,0,0,0,0,6
8,0,10,0,0,0,0,0,4,4,4,4,4,4,4,4,4,4,2,3,0,0,0,0,2,2,3,3,2,2,0,4,4,0,0,0,0,8
7,4,4,4,4,4,4,4,4,4,4,4,4,4,4,4,4,4,2,3,0,0,0,0,2,2,3,3,2,2,0,4,4,4,4,4,4,7
7,4,4,4,4,4,4,4,4,4,4,4,4,4,4,4,4,4,2,3,0,0,11,0,2,2,2,2,2,2,0,4,4,4,4,4,4,7
9,0,0,0,0,0,0,0,4,4,4,4,4,4,4,4,4,4,2,3,0,0,10,0,0,0,2,2,2,2,2,2,0,0,0,0,0,9
9,0,0,0,11,0,0,0,4,4,4,4,4,4,4,4,4,4,3,3,0,0,0,0,0,0,2,2,2,2,2,2,2,0,0,0,0,9
9,0,0,0,10,0,0,0,0,0,0,0,0,0,0,0,0,0,0,0,0,0,0,0,0,0,0,0,2,2,2,2,2,2,2,2,0,9
1,1,1,1,1,1,1,1,1,1,1,1,1,1,1,1,1,1,1,1,1,1,1,1,1,1,1,1,5,5,5,5,5,5,5,5,1,1